5 6
8 2 7 8
2 2 3 1 4 
2 1 3 3 4 
2 3 3 2 1 3 
2 3 3 0 2 1 
. \ . . . 
\ . . / . 
\ . . \ . 
. . . . . 
. . . . . 
. . . . . 