5 4
3 2 5 4
1 4 0 3 1 
1 0 0 3 2 
2 5 2 3 
0 0 2 3 
. . . . . 
. | / . - 
| . . . . 
. - . . \ 