6 6
7 7 7 8
0 4 1 4 2 2 
1 4 3 4 2 2 
4 0 3 2 3 1 
4 7 2 3 0 1 
. . . . . . 
- | \ . . . 
. . / | . . 
/ . . . . . 
. . . . . | 
. . . . . . 