6 5
6 7 4 6
1 0 2 3 3 2 
1 3 2 1 1 4 
3 2 1 3 1 
3 2 0 0 1 
. - . . / . 
. | . . . . 
| . . - / \ 
. . . . . . 
. . . . . . 