5 5
4 4 5 5
2 1 0 3 0 
2 0 4 3 0 
0 0 2 2 2 
5 3 2 2 0 
. | - . - 
. \ . . . 
. . . . . 
. . | . | 
. . . . / 