6 5
4 5 5 9
6 3 1 0 0 3 
0 3 1 2 1 3 
2 2 2 0 1 
0 2 2 1 1 
. . . \ . . 
. \ . . \ | 
. - . . . . 
. . . . . . 
\ . . | . . 